11111111111111111111111111111111
1C010000000C00000000C11111C000E1
10000111110011110000001111101111
1P00111000001C000111000C00000C11
11101C11011110011110001110011111
11101011C000000011100111C0001111
110010111100C1101110011100011111
110010111100111C111000111000C001
100C10011100011000000C111C000001
10111101110C0111110001111111C001
10110001111000000110011111C00001
10000C0111111C000110011111001111
111100000C000000111C0000C0001111
1111C000000011111110000000001111
11111111111111111111111111111111
